Gotta Be | Isenberg | Gotta Be => NOT FOUND

Living For The City | Stevie Wonder | The Definitive Collection (Deluxe Edition) => NOT FOUND

Florida Thang | Pouya | SUPERMAN IS DEAD => NOT FOUND

Kushmas | Smino | High 4 Da Highladays => NOT FOUND

Althea - 2013 Remaster | Grateful Dead | Go to Heaven => NOT FOUND

Hung Up On My Baby | Isaac Hayes | Legenden des Soul - Isaac Hayes => NOT FOUND

Fluff - 2013 Remaster | Black Sabbath | Sabbath Bloody Sabbath (2014 Remaster) => NOT FOUND

Ain\'t Doin That | Playboi Carti, Southside | Trap Ye Season 2 => NOT FOUND

Mary\'s Theme | Stelvio Cipriani | Femina Ridens (Original Motion Picture Soundtrack) => NOT FOUND

The Ballad | Blur | The Ballad of Darren => NOT FOUND

Down by the Seaside - Remaster | Led Zeppelin | Physical Graffiti (Deluxe Edition) => NOT FOUND

The End | The Doors | The Doors => NOT FOUND

spliff | Knowmadic | bumps => NOT FOUND

Whole Lotta Love - 1990 Remaster | Led Zeppelin | Led Zeppelin II (1994 Remaster) => NOT FOUND

Callin\' Out | Lyrics Born, Joyo Velarde, Gift Of Gab, Blackalicious | Callin\' out 12" => NOT FOUND

Five to One | The Doors | Waiting for the Sun => NOT FOUND

Who Loves the Sun - 2015 Remaster | The Velvet Underground | Loaded: Re-Loaded 45th Anniversary Edition => NOT FOUND

Hypnotized | Fleetwood Mac | Mystery to Me => NOT FOUND

Air (feat. DOOM) | Dabrye, MF DOOM | Two / Three => NOT FOUND

Cream Puff War - 2013 Remaster | Grateful Dead | The Grateful Dead => NOT FOUND

El Avión | Supermerk2 | Supermerk2 & Meta Guacha: 2x1 => NOT FOUND

N.I.B. | Black Sabbath | The Ultimate Collection => NOT FOUND

Rocket Man | jayden | Rocket Man => NOT FOUND

Baptize (with JID & EARTHGANG feat. Ant Clemons) | Spillage Village, JID, EARTHGANG, Ant Clemons | Baptize (with JID & EARTHGANG feat. Ant Clemons) => NOT FOUND

Águas De Março | Elis Regina, Antônio Carlos Jobim | Ritmo Brasilero => NOT FOUND

I\'m Just a Guitar (Everybody Picks on Me) | Pete Drake | Presenting Pete Drake => NOT FOUND

B.Q.E | Kota the Friend, Joey Bada$$, Bas | B.Q.E => NOT FOUND

ザ・ワード II | SHIGEO SEKITO | 華麗なるエレクトーン -ザ・ワード- => NOT FOUND

Costa Rica | Bankrol Hayden | Costa Rica => NOT FOUND

Meek Mill x Tv Girl Rmx | RU Music Hub | Meek Mill x Tv Girl Rmx => NOT FOUND

Turn on Your Love Light - Live at San Francisco; 2001 Remaster | Grateful Dead | Live / Dead => NOT FOUND

Cars Hiss by My Window | The Doors | L.A. Woman => NOT FOUND

(Sweet Sweet Baby) Since You\'ve Been Gone | Aretha Franklin | Lady Soul (With Bonus Selections) => NOT FOUND

monclizzy | bill clesen | monclizzy => NOT FOUND

No Quarter - (Live at MSG 1973) [Remaster] | Led Zeppelin | The Song Remains the Same (Remaster) => NOT FOUND

Culture | DRACO | Culture => NOT FOUND

RUDEBWOY (feat. Joey Bada$$) | CJ Fly, Joey Bada$$, Statik Selektah | RUDEBWOY (feat. Joey Bada$$) => NOT FOUND

Truckin\' - 2013 Remaster | Grateful Dead | American Beauty (2013 Remaster) => NOT FOUND

Take Me For a Little While | The Royal Jesters | Royal Jesters: English Oldies => NOT FOUND

Black Dog - Remaster | Led Zeppelin | Led Zeppelin IV (Deluxe Edition) => NOT FOUND

Nauseous / Devilish | Vegyn, JPEGMAFIA | Nauseous / Devilish => NOT FOUND

La Resaka | Supermerk2 | Supermerk2 & Meta Guacha: 2x1 => NOT FOUND

Changes | Instant Pleasure | Welcome to Plastic City 2495 => NOT FOUND

FALL BACK | Duckwrth | FALL BACK => NOT FOUND

Risk | FKJ, Bas | Risk => NOT FOUND

Carta Ao Tom 74 | Vinícius de Moraes, Toquinho, Quarteto Em Cy | 20 Grandes Sucessos De Vinicius De Moreas => NOT FOUND

Sweet Jane | The Velvet Underground | Loaded: Re-Loaded 45th Anniversary Edition => NOT FOUND

Contigo | Germán Valdés "Tin Tan" | Germán Valdés TIN-TAN Canciones de Sus Películas => NOT FOUND

Ventura Highway | America, George Martin | Homecoming => NOT FOUND

Greetings | Joni Haastrup | Soul Jazz Records Presents Nigeria Soul Fever: Afro Funk, Disco And Boogie: West African Disco Mayhem! => NOT FOUND

When the Levee Breaks - Remaster | Led Zeppelin | Led Zeppelin IV (Deluxe Edition) => NOT FOUND

Try a Little Tenderness | Otis Redding | Complete & Unbelievable: The Otis Redding Dictionary of Soul => NOT FOUND

Limelight (NGHTMRE Remix) | Just A Gent, NGHTMRE | Limelight (NGHTMRE Remix) => NOT FOUND

Where Did You Sleep Last Night | Lead Belly | Tradition Masters Series => NOT FOUND

Queen of the Highway | The Doors | Morrison Hotel => NOT FOUND

War Pigs | Black Sabbath | The Ultimate Collection => NOT FOUND

Lady Stardust - 2012 Remaster | David Bowie | The Rise and Fall of Ziggy Stardust and the Spiders from Mars (2012 Remaster) => NOT FOUND

Backlash Blues | Nina Simone | Nina Simone Sings The Blues (Expanded Edition) => NOT FOUND

Have You Ever Seen The Rain | Creedence Clearwater Revival | Pendulum => NOT FOUND

The Last Man On Earth | Wolf Alice | The Last Man On Earth => NOT FOUND

You Feel Me | Papithbk | Thbk => NOT FOUND

Riot | Hugh Masekela | Best Of/20th Century => NOT FOUND

Future Games | Fleetwood Mac | Future Games => NOT FOUND

Hooked on You | Kolter | Hooked => NOT FOUND

Bruuuh (with Denzel Curry) - Remix | JID, Denzel Curry | Bruuuh (with Denzel Curry) [Remix] => NOT FOUND

Boy Story | GOON DES GARCONS* | Boy Story => NOT FOUND

Squidwards Nose (feat. Kg Prince) | Joey Trap, Kg Smokey, Kg Prince | Squidwards Nose (feat. Kg Prince) => NOT FOUND

Waiting for the Sun | The Doors | Morrison Hotel => NOT FOUND

 |  |  => NOT FOUND

Carefree | Mick Jenkins | Carefree => NOT FOUND

Ramble Tamble | Creedence Clearwater Revival | Cosmo\'s Factory => NOT FOUND

You Can\'t Change A Man | Christy Essien | Soul Jazz Records Presents Nigeria Soul Fever: Afro Funk, Disco And Boogie: West African Disco Mayhem! => NOT FOUND

Rock Steady | Aretha Franklin | Young, Gifted and Black => NOT FOUND

Snowblind - 2014 Remaster | Black Sabbath | Vol. 4 (2014 Remaster) => NOT FOUND

Rapp Snitch Knishes feat. Mr. Fantastik | MF DOOM | MM...FOOD => NOT FOUND

Sway (Quien Sera) | Dean Martin | Dean Martin: The Capitol Recordings, Vol. 5 (1954) => NOT FOUND

How Soon Is Now? - 2011 Remaster | The Smiths | Hatful of Hollow => NOT FOUND

Fire on the Mountain - 2013 Remaster | Grateful Dead | Shakedown Street => NOT FOUND

When It\'s Time to Go | Buddy Fo & His Group | When It\'s Time to Go => NOT FOUND

Look To The Sky | Antônio Carlos Jobim | Wave => NOT FOUND

Touch Me | The Doors | The Soft Parade => NOT FOUND

Sleepwalk | Santo & Johnny | Sleepwalk => NOT FOUND

In the Light - Remaster | Led Zeppelin | Physical Graffiti (Deluxe Edition) => NOT FOUND

Preludio | Luiz Bonfá | Amor! Fabulous Guitar Of Luiz Bonfa => NOT FOUND

Monkberry Moon Delight - Remastered 2012 | Paul McCartney, Linda McCartney | Ram (Archive Collection) => NOT FOUND

Mississippi Half-Step Uptown Toodeloo - 2013 Remaster | Grateful Dead | Wake of the Flood (2013 Remaster) => NOT FOUND

Misty Mountain Hop - Remaster | Led Zeppelin | Led Zeppelin IV (Remaster) => NOT FOUND

Midnight Special - Remastered 2007/Rudy Van Gelder Edition | Jimmy Smith | Midnight Special (Remastered) => NOT FOUND

Pineapple and the Monkey | Faces | First Step => NOT FOUND

Superman Is Dead | Pouya | SUPERMAN IS DEAD => NOT FOUND

Cookie Chips | Rejjie Snow, MF DOOM, Cam O\'bi | Cookie Chips => NOT FOUND

Hypnotize - 2014 Remaster | The Notorious B.I.G. | Life After Death (2014 Remastered Edition) => NOT FOUND

Sweet Jane | The Velvet Underground | Loaded: The Fully Loaded Edition => NOT FOUND

Sisyphus | Quadeca | Sisyphus => UNABLE TO ADD TO PLAYLIST

Millidelphia (feat. Swizz Beatz) | Meek Mill, Swizz Beatz | Legends of the Summer => NOT FOUND

THOT! | TOKYO’S REVENGE, ZEDSU | THOT! => NOT FOUND

Slumpin | Jinsang, Various Artists | Chillhop Raw Cuts 2 => NOT FOUND

Pua Hala | Kalua Beach Boys | Reader\'s Digest Presents - Island Magic, Essential Hawaiian Music => NOT FOUND

Murder On The Dancefloor | Sophie Ellis-Bextor | Read My Lips (Deluxe Version) => NOT FOUND

moneytalk | bbno$, Juelz | moneytalk => NOT FOUND

O Astronauta | Baden Powell | À Vontade => NOT FOUND

Lo Chiamavano King (His Name Is King) | Luis Bacalov, Edda Dell\'Orso | Quentin Tarantino’s Django Unchained Original Motion Picture Soundtrack => NOT FOUND

In Memory Of Elizabeth Reed | Allman Brothers Band | Idlewild South (Deluxe Edition Remastered) => NOT FOUND

Ten Years Gone - Remaster | Led Zeppelin | Physical Graffiti (Deluxe Edition) => NOT FOUND

Oh Girl | The Chi-Lites | Hit Highlights from the Chi-Lites => NOT FOUND

Cien años | Pedro Infante | 15 Inmortales de Pedro Infante => NOT FOUND

Theme from Taxi Driver | Bernard Herrmann, Dave Blume | Taxi Driver => NOT FOUND

Romeo Had Juliette | Lou Reed | New York => NOT FOUND

Eyes of the World - 2013 Remaster | Grateful Dead | Wake of the Flood (2013 Remaster) => NOT FOUND

Sprague Street | Kipp Stone, Mick Jenkins | Sprague Street => NOT FOUND

What\'s Up? | 4 Non Blondes | Bigger, Better, Faster, More ! => NOT FOUND

Here She Comes - Remastered 2000 | The Beach Boys | Carl & The Passions - So Tough (Remastered) => NOT FOUND

Sunny Side of Heaven | Fleetwood Mac | Bare Trees => NOT FOUND

Transportin\' | Kodak Black | Project Baby 2: All Grown Up => NOT FOUND

 |  |  => NOT FOUND

Estate | Lelio Luttazzi | Le mie preferite => NOT FOUND

Blood on the Risers (Gory Gory What a Helluva Way to Die) | American Paratrooper | Blood on the Risers (Gory Gory What a Helluva Way to Die) => NOT FOUND

Village Of The Sun - Live From Erie, PA - November 12, 1974 | Frank Zappa | Village Of The Sun / You Didn\'t Try To Call Me (Live) => NOT FOUND

Say Nothing | Mall Grab | Say Nothing => NOT FOUND

What I Please (feat. Denzel Curry) | Smokepurpp, Denzel Curry | What I Please (feat. Denzel Curry) => NOT FOUND

Heart Of The Country - Remastered 2012 | Paul McCartney, Linda McCartney | Ram (Archive Collection) => NOT FOUND

Orchid - 2014 Remaster | Black Sabbath | Master of Reality (2014 Remaster) => NOT FOUND

Romance | Hiroshi Suzuki | WaJazz: Japanese Jazz Spectacle Vol.I - Deep, Heavy and Beautiful Jazz from Japan 1968-1984 - The Nippon Columbia masters - Selected by Yusuke Ogawa (Universounds) => NOT FOUND

 |  |  => NOT FOUND

Shakedown Street - 2013 Remaster | Grateful Dead | Shakedown Street => NOT FOUND

Soul Man | Sam & Dave | Soul Men => NOT FOUND

The Rain Song - Remaster | Led Zeppelin | Houses of the Holy (Remaster) => NOT FOUND

Oj in My Gucci Bag | lilbootycall | Oj in My Gucci Bag => NOT FOUND

Up the Beach | Jane\'s Addiction | Nothing\'s Shocking => NOT FOUND

Blue Sunday | The Doors | Morrison Hotel => NOT FOUND

Jack Straw - Live at Barton Hall, Cornell University, Ithaca, NY 5/8/77 | Grateful Dead | Cornell 5/8/77 (Live) => NOT FOUND

Spooky | Dusty Springfield | Dusty... Definitely (Expanded Edtion) => NOT FOUND

Iron Man - 2012 - Remaster | Black Sabbath | Paranoid (Remaster) => NOT FOUND

Small Worlds | Mac Miller | Swimming => NOT FOUND

Starman - 2012 Remaster | David Bowie | The Rise and Fall of Ziggy Stardust and the Spiders from Mars (2012 Remaster) => NOT FOUND

Purple Haze | Jimi Hendrix | Are You Experienced => NOT FOUND

ARE YOU WITH THAT? | Vince Staples | ARE YOU WITH THAT? => NOT FOUND

Ghost of Myself | Doris Duke | Swamp Dogg Presents Doris Duke & Patti Labelle and the Bluebelles => NOT FOUND

Lounge Music | Michael Small | \'klute\' - Original Soundtrack Recording - Remastered => NOT FOUND

Rooster (2022 Remaster) | Alice In Chains | Dirt (2022 Remaster) => NOT FOUND

Who Knows - Live At Fillmore East, 1970 / 50th Anniversary | Jimi Hendrix | Band Of Gypsys (50th Anniversary / Live) => NOT FOUND

I Saw the Light | Todd Rundgren | Something / Anything? => NOT FOUND

Bricks | Joey Trap | Trap Jack => NOT FOUND

Tell Me More And More And Then Some | Nina Simone | Ne Me Quitte Pas => NOT FOUND

Whipping Post | Allman Brothers Band | The Allman Brothers Band (Deluxe) => NOT FOUND

Franklin\'s Tower - 2013 Remaster | Grateful Dead | Blues for Allah (2013 Remaster) => NOT FOUND

No Fires It | McWoner | Well Charged => NOT FOUND

Oh! Sweet Nuthin\' - 2015 Remaster | The Velvet Underground | Loaded: Re-Loaded 45th Anniversary Edition => NOT FOUND

The Crystal Ship | The Doors | The Doors => NOT FOUND

My Own Summer (Shove It) | Deftones | Around the Fur => NOT FOUND

Cereal (feat. Kenny Mason) | IDK, JID, Kenny Mason | Cereal (feat. Kenny Mason) => NOT FOUND

We\'re Finally Landing | Home | Before the Night => NOT FOUND

Life on Mars? - 2015 Remaster | David Bowie | Hunky Dory (2015 Remaster) => NOT FOUND

Over You - Live At The Matrix, San Francisco, CA / 1969 | The Velvet Underground | 1969: Velvet Underground Live with Lou Reed Vol. 2 => NOT FOUND

When the Music\'s Over | The Doors | Strange Days => NOT FOUND

Pictures Of Matchstick Men | Status Quo | Gold => NOT FOUND

Island Style | John Cruz, Jack Johnson, Jackson Browne | Jack Johnson & Friends: Best Of Kokua Festival, A Benefit For The Kokua Hawaii Foundation => NOT FOUND

NO REASON | KANYE DROP YOUR ALBUMS | KANYE DROP YOUR ALBUMS => NOT FOUND

Mushroom Clouds | Like | Songs Made While High => NOT FOUND

Good to Me as I Am to You | Aretha Franklin | Lady Soul (With Bonus Selections) => NOT FOUND

I Saw the Light - 2015 Remaster | Todd Rundgren | Something / Anything? => NOT FOUND

 |  |  => NOT FOUND

Angie - Remastered 2009 | The Rolling Stones | Goats Head Soup (Remastered 2009) => NOT FOUND

One Beer | MF DOOM | MM...FOOD => NOT FOUND

Nobody Knows You When You\'re Down And Out | Scrapper Blackwell | Mr. Scrapper\'s Blues => NOT FOUND

Take It Easy - 2013 Remaster | Eagles | Eagles (2013 Remaster) => NOT FOUND

I Found a Reason - 2015 Remaster | The Velvet Underground | Loaded (2015 Remaster) => NOT FOUND

Stay with Me | Faces | A Nod Is as Good as a Wink... to a Blind Horse => NOT FOUND

Suicide Year Weedmane | Abdi The Engineer | Suicide Year Weedmane => NOT FOUND

Not for Me | Unicorn On Ketamine | Not for Me => NOT FOUND

Light My Fire | The Doors | The Doors => NOT FOUND

Sorcerers feat. MF Doom & Invizible Handz | John Robinson, MF DOOM, Invizible Handz | Silent In Truth => NOT FOUND

Paranoid - 2012 - Remaster | Black Sabbath | Paranoid (Remaster) => NOT FOUND

サラヴァ! | 高橋ユキヒロ | サラヴァ! => NOT FOUND

Fame - 2016 Remaster | David Bowie | Young Americans (2016 Remaster) => NOT FOUND

60mgs | oshrare | 60mgs => NOT FOUND

Ain\'t No Mountain High Enough | Marvin Gaye, Tammi Terrell | United => NOT FOUND

Sad Nigga Hours | Lil Boom, 904TEZZO | Sad Nigga Hours => NOT FOUND

Reality | Black Merda! | The Folks From Mother\'s Mixer => NOT FOUND

Jovial | Limes | Fresh Squeezed => NOT FOUND

Heaven Knows I\'m Miserable Now - 2011 Remaster | The Smiths | Louder Than Bombs => NOT FOUND

coasting | bbno$, hollow, Futon | coasting => NOT FOUND

Time (feat. Ariana Grande) | Childish Gambino, Ariana Grande | 3.15.20 => NOT FOUND

Only over You - 2016 Remaster | Fleetwood Mac | Mirage (Deluxe Edition) => NOT FOUND

Overture | "Jesus Christ Superstar" Orchestra, Andrew Lloyd Webber, Tim Rice | Jesus Christ Superstar => NOT FOUND

I\'m So Grateful (feat. Densaid) - Angel\'s Smooth Mix | Kings Of Tomorrow, Densaid | I\'m So Grateful (feat. Densaid) [Remixes] => NOT FOUND

Emerald Eyes | Fleetwood Mac | Mystery to Me => NOT FOUND

Bring It on Home - Remaster | Led Zeppelin | Led Zeppelin II (Remaster) => NOT FOUND

The Dream Is Always The Same - From \'Risky Business\' Original Motion Picture Soundtrack | Tangerine Dream | Hyperborea (Deluxe Version / Remastered 2020) => UNABLE TO ADD TO PLAYLIST

BNR | Crumb | BNR & Balloon => NOT FOUND

BODYCOUNT (feat. Jasiah) | TOKYO’S REVENGE, Jasiah | BODYCOUNT (feat. Jasiah) => NOT FOUND

God Smack (2022 Remaster) | Alice In Chains | Dirt (2022 Remaster) => NOT FOUND

Got Me Wrong - Live at the Majestic Theatre, Brooklyn, NY - April 1996 | Alice In Chains | Unplugged => NOT FOUND

The Wizard - 2014 Remaster | Black Sabbath | Black Sabbath (2014 Remaster) => NOT FOUND

Oh! You Pretty Things - 2015 Remaster | David Bowie | Hunky Dory (2015 Remaster) => NOT FOUND

Teeth | DJ Dread | One Life => NOT FOUND

For What It\'s Worth | Buffalo Springfield | Buffalo Springfield => NOT FOUND

Doralice | Adriana Arias | Outra Vez => NOT FOUND

Trampled Under Foot - Remaster | Led Zeppelin | Physical Graffiti (Deluxe Edition) => NOT FOUND

Wat U Sed (feat. Doechii & Kal Banx) | Isaiah Rashad, Doechii, Kal Banx | Wat U Sed (feat. Doechii & Kal Banx) => NOT FOUND

Butter | Babe Rainbow | Today => UNABLE TO ADD TO PLAYLIST

People Are Strange | The Doors | Strange Days => UNABLE TO ADD TO PLAYLIST

Sweetness - 2003 Remaster | Yes | Yes (Deluxe Edition) => NOT FOUND

Can\'t You Hear Me Knocking - 2009 Mix | The Rolling Stones | Sticky Fingers (Remastered) => NOT FOUND

Right - Alternative Gouster Mix | David Bowie | Who Can I Be Now? [1974 - 1976] => NOT FOUND

Train Leaves Here This Morning - 2013 Remaster | Eagles | Eagles (2013 Remaster) => NOT FOUND

Now or Never | Big L | Now or Never => NOT FOUND

Think | Aretha Franklin | Aretha Now => NOT FOUND

HURTWORLD \'99 | City Morgue, ZillaKami, SosMula | HURTWORLD \'99 => NOT FOUND

Saudade Fêz um Samba | João Gilberto | João Gilberto Apresenta Chega de Saudade => NOT FOUND

The Red Telephone - 2015 Remaster | Love | Forever Changes (2015 Remaster) => NOT FOUND

Wild Goose Chase | Steel Pulse | Earth Crisis => NOT FOUND

Runnin\' Blue | The Doors | The Soft Parade => NOT FOUND

Day Tripper - Remastered 2015 | The Beatles | 1 (Remastered) => NOT FOUND

Dust in the Wind | Todd Rundgren | Something / Anything? => NOT FOUND

Souvenir d\'Italie | Lelio Luttazzi | Le mie preferite => NOT FOUND

Space Oddity - 2015 Remaster | David Bowie | David Bowie (aka Space Oddity) [2015 Remaster] => NOT FOUND

While My Guitar Gently Weeps | Tom Petty, Jeff Lynne, Steve Winwood, Dhani Harrison, Prince | Rock and Roll Hall of Fame Volume 8: 2004-2005 => NOT FOUND

Jewel Eyed Judy - 2018 Remaster | Fleetwood Mac | Kiln House => NOT FOUND

Satsuki - Jazzy Nice Metropolis Mix | Richard Worth, Jazzy Nice, Gengji Siraisi | Giant Step NYC presents SATSUKI => NOT FOUND

Samba pro Rafa | Yamandu Costa | Mafuá => NOT FOUND

The Ghost Song | Jim Morrison, Music By The Doors | An American Prayer => NOT FOUND

I Know It\'s Over - 2011 Remaster | The Smiths | The Queen Is Dead => NOT FOUND

Your House | Steel Pulse | True Democracy => NOT FOUND

BEST INTEREST | Tyler\, The Creator | BEST INTEREST => NOT FOUND

No Idea | Don Toliver | Heaven Or Hell => NOT FOUND

Well I Wonder - 2011 Remaster | The Smiths | Meat Is Murder => NOT FOUND

Estimated Prophet - 2014 Remaster | Grateful Dead | Terrapin Station (2014 Remaster) => NOT FOUND

Up Around The Bend | Creedence Clearwater Revival | Cosmo\'s Factory => NOT FOUND

Roll in Peace (feat. XXXTENTACION) | Kodak Black, XXXTENTACION | Project Baby 2: All Grown Up => NOT FOUND

Hyacinth House | The Doors | L.A. Woman => NOT FOUND

Midnight Rider | Allman Brothers Band | Idlewild South (Deluxe Edition Remastered) => NOT FOUND

Sweet Leaf - 2014 Remaster | Black Sabbath | Master of Reality (2014 Remaster) => NOT FOUND

Casey Jones - 2013 Remaster | Grateful Dead | Workingman\'s Dead => NOT FOUND

Terry | Action Bronson | Mr. Wonderful => NOT FOUND

Bennie And The Jets | Elton John | Elton John\'s Greatest Hits => NOT FOUND

Babe I\'m Gonna Leave You - 1990 Remaster | Led Zeppelin | Led Zeppelin => NOT FOUND

Deal - Live at Barton Hall, Cornell University, Ithaca, NY 5/8/77 | Grateful Dead | Cornell 5/8/77 (Live) => NOT FOUND

Down In A Hole - Live at the Majestic Theatre, Brooklyn, NY - April 1996 | Alice In Chains | Unplugged => NOT FOUND

Plead The .45th | Smino, Saba | Plead The .45th => NOT FOUND

Signed, Sealed, Delivered (I\'m Yours) | Stevie Wonder | Signed, Sealed And Delivered => NOT FOUND

Dramma della gelosia, pt. 2 | Armando Trovajoli | Dramma della gelosia (Tutti i particolari in cronaca) [Colonna sonora originale del film] => NOT FOUND

Then Came the Last Days of May | Blue Öyster Cult | Blue Oyster Cult => NOT FOUND

Psycho | slowthai, Denzel Curry | Psycho => NOT FOUND

Break | sandy g archive | Break => NOT FOUND

Tim Dom Dom | João Donato | Muito À Vontade => NOT FOUND

Half a Person - 2011 Remaster | The Smiths | Louder Than Bombs => NOT FOUND

End of the Night | The Doors | The Doors => NOT FOUND

Third Stone From The Sun | Dick Dale | Guitar Legend: The Very Best Of Dick Dale => NOT FOUND

Harvest Moon (From "A Quiet Place") | Soundtrack Wonder Band | Neil Young Movie Music => NOT FOUND

In My Time of Dying - Remaster | Led Zeppelin | Physical Graffiti (Remaster) => NOT FOUND

G Walkin\' on Yo Coffin | Lil Boodang | G Walkin\' on Yo Coffin => NOT FOUND

Maggie\'s Farm - Live at Newport Folk Festival, Newport, RI - July 1965 | Bob Dylan | No Direction Home: Bootleg Volume 7 (Movie Soundtrack) => NOT FOUND

Killing Floor | Howlin\' Wolf | The Real Folk Blues => NOT FOUND

The Wind Cries Mary | Jimi Hendrix | Are You Experienced => NOT FOUND

Rock & Roll - Mono; 2015 Remaster | The Velvet Underground | Loaded: Re-Loaded 45th Anniversary Edition => NOT FOUND

Hideaway | Freddie King | Is A Blues Master => NOT FOUND

That\'s Life | Still Woozy | That\'s Life => NOT FOUND

MAGIC! | KIL, EGOVERT | MAGIC! => NOT FOUND

Love Street | The Doors | Waiting for the Sun => NOT FOUND

Custard Pie - Remaster | Led Zeppelin | Physical Graffiti (Deluxe Edition) => NOT FOUND

Don\'t Want You No More | Allman Brothers Band | The Allman Brothers Band (Deluxe) => NOT FOUND

Band On The Run - 2010 Remaster | Paul McCartney, Wings | Band On The Run => NOT FOUND

Been down so Long | The Doors | L.A. Woman => NOT FOUND

I Don\'t Live Today - Live at the Los Angeles Forum, Inglewood, CA - April 26, 1969 | Jimi Hendrix | I Don\'t Live Today (Live at the Los Angeles Forum, Inglewood, CA - April 26, 1969) => NOT FOUND

Across the Stars (Love Theme from "Star Wars, Episode II") | London Voices, London Symphony Orchestra, John Williams, New London Children\'s Choir | Star Wars: Attack of the Clones (Original Motion Picture Soundtrack) => NOT FOUND

Wii Trapped | Joey Trap | Trapped in TV => NOT FOUND

Doomsday | MF DOOM, MF Grimm | Best of Mf => NOT FOUND

Ballads (with Conway The Machine) | JID, Conway the Machine | Ballads (with Conway The Machine) => NOT FOUND

Power To Love - Live At Fillmore East, 1970 / 50th Anniversary | Jimi Hendrix | Band Of Gypsys (50th Anniversary / Live) => NOT FOUND

She’s My Baby - 2014 Remaster | Wings | Wings At The Speed Of Sound (Archive Collection) => NOT FOUND

Problemz (feat. Erick The Architect, CJ Fly, The Underachievers, Zombie Juice & Nyck Caution) | Beast Coast, Joey Bada$$, Flatbush Zombies, Erick the Architect, CJ Fly, The Underachievers, Zombie Juice, Nyck Caution | Escape From New York => NOT FOUND

Hotel California - 2013 Remaster | Eagles | Hotel California (2013 Remaster) => NOT FOUND

Tax Free | Jimi Hendrix | Miami Pop Festival => NOT FOUND

Flashing Lights | Kanye West, Dwele | Graduation => UNABLE TO ADD TO PLAYLIST

I Don\'t Owe You Anything - 2011 Remaster | The Smiths | The Smiths => NOT FOUND

Oba, Lá Vem Ela | Jorge Ben Jor | Favourites: From Samba Esquema Novo 1963 To Africa Brasil 1976 => NOT FOUND

Hey, Hey, What Can I Do - Remaster | Led Zeppelin | Coda (Deluxe Edition) => NOT FOUND

Hand of Doom - 2012 - Remaster | Black Sabbath | Complete Studio Albums 1970 - 1978 => NOT FOUND

Gunna-Woke Up | Maskedupleaks | Gunna-Woke Up => NOT FOUND

Scarlet Begonias - Live at Barton Hall, Cornell University, Ithaca, NY 5/8/77 | Grateful Dead | Cornell 5/8/77 (Live) => NOT FOUND

Yum Yum Cult | TOBACCO | Fucked up Friends => NOT FOUND

Goo Goo Wah Wah | Wah Wah Watson | Elementary (Expanded Edition) => UNABLE TO ADD TO PLAYLIST

Quem Vem Pra Beira Do Mar | Dorival Caymmi | Dê Lembranças A Todos (Original Motion Picture Soundtrack) => UNABLE TO ADD TO PLAYLIST

Ziggy Stardust - 2012 Remaster | David Bowie | The Rise and Fall of Ziggy Stardust and the Spiders from Mars (2012 Remaster) => NOT FOUND

Night and Day | Luiz Bonfá | Solo in Rio 1959 => UNABLE TO ADD TO PLAYLIST

カーリーとキャロル | SHIGEO SEKITO | 華麗なるエレクトーン -ザ・ワード- => NOT FOUND

Peace Frog | The Doors | Morrison Hotel => NOT FOUND

Lucky You | Jody Williams, Earl Hooker | Presenting Jody Williams => NOT FOUND

What Is and What Should Never Be - 1990 Remaster | Led Zeppelin | Led Zeppelin II (1994 Remaster) => NOT FOUND

Lovelovelove | Flea | Helen Burns => UNABLE TO ADD TO PLAYLIST

Supernaut - 2014 Remaster | Black Sabbath | Vol. 4 (2014 Remaster) => NOT FOUND

L\'amore dice ciao (From "La matriarca - The Libertine") - Main Titles | Armando Trovajoli | Romantic, Film Music Collection => NOT FOUND

Be Quiet and Drive (Far Away) | Deftones | Around the Fur => NOT FOUND

Into the Void - 2014 Remaster | Black Sabbath | Master of Reality (2014 Remaster) => NOT FOUND

Straight Outta Compton | N.W.A. | Straight Outta Compton (2002 - Remaster) => NOT FOUND

The Weekend - Funk Wav Remix | SZA, Calvin Harris, Funk Wav | The Weekend (Funk Wav Remix) => NOT FOUND

Indian Summer | The Doors | Morrison Hotel => NOT FOUND

Conversa De Poeta | Baden Powell | Baden Powell À Vontade => NOT FOUND

You Don\'t Miss Your Water | Otis Redding | Otis Blue => NOT FOUND

I Fall in Love Too Easliy | Caleb Belkin | Discography => NOT FOUND

High You Are | What So Not, Branchez | High You Are (Remixes) => NOT FOUND

Dramma della gelosia - Titoli | Armando Trovajoli | Dramma della gelosia (Tutti i particolari in cronaca) [Colonna sonora originale del film] => NOT FOUND

The Big Rock Candy Mountain | Harry McClintock | Bona Fide Bluegrass and Mountain Music => NOT FOUND

Headshots (4r da Locals) | Isaiah Rashad | Headshots (4r Da Locals) => NOT FOUND

Would? (2022 Remaster) | Alice In Chains | Dirt (2022 Remaster) => NOT FOUND

Easter Sunday | Zelooperz, Earl Sweatshirt | Dyn-O-Mite => NOT FOUND

Respect | Otis Redding | The Very Best of Otis Redding => NOT FOUND

Alone in the Night | Michael Small | \'klute\' - Original Soundtrack Recording - Remastered => NOT FOUND

Terrapin Station Medley - 2014 Remaster | Grateful Dead | Terrapin Station (2014 Remaster) => NOT FOUND

Hotel California - Live at The Forum, Los Angeles, CA, 10/20-22/1976 | Eagles | Hotel California (40th Anniversary Expanded Edition) => NOT FOUND

Mobius Trip | H.P. Lovecraft | H. P. Lovecraft II => NOT FOUND

Ship of Fools - 2013 Remaster | Grateful Dead | From the Mars Hotel => NOT FOUND

Hoochie Coochie Man | Allman Brothers Band | Idlewild South (Deluxe Edition Remastered) => NOT FOUND

Civilized Worm | Melvins | A Senile Animal => NOT FOUND

Wichita Lineman - Remastered 2001 | Glen Campbell | Wichita Lineman (Remastered) => NOT FOUND

The Human Centipede | Ski Mask The Slump God | The Human Centipede => NOT FOUND

Lake Shore Drive | Aliotta Haynes Jeremiah | Lake Shore Drive => NOT FOUND

Samson and Delilah - Live at Red Rocks Amphitheatre, Morrison, CO 7/8/78 | Grateful Dead | Red Rocks Amphitheatre, Morrison, CO 7/8/78 (Live) => NOT FOUND

Lil Arrogant (feat. Joey Bada$$ & Russ) | IDK, Joey Bada$$, Russ | Lil Arrogant (feat. Joey Bada$$ & Russ) => NOT FOUND

dirt | KIL | dirt => NOT FOUND

Early Summer | Ryo Fukui | シーナリィ => NOT FOUND

Distance (feat. Issa Gold & Erick The Architect) | Beast Coast, Joey Bada$$, Flatbush Zombies, Issa Gold, Erick the Architect, Powers Pleasant | Escape From New York => NOT FOUND

San-Ho-Zay | Freddie King | Texas Sensation => NOT FOUND

Too Late To Turn Back Now | Cornelius Brothers & Sister Rose | The Story Of Cornelius Brothers & Sister Rose => NOT FOUND

Dirt (2022 Remaster) | Alice In Chains | Dirt (2022 Remaster) => NOT FOUND

I Love You More Than Words Can Say - Mono | Otis Redding | The Dock of the Bay (Mono) => NOT FOUND

O Astronauta | Baden Powell | Baden Powell À Vontade => NOT FOUND

Brain Stew | Green Day | Insomniac => NOT FOUND

0181 000 0010 | 00110100 01010100 | 0181 => NOT FOUND

Devil Got My Woman | Skip James | I\'d Rather Be The Devil: The Legendary 1931 Session => NOT FOUND

Almost Cut My Hair | Crosby\, Stills\, Nash & Young | Deja Vu => NOT FOUND

Travelling Riverside Blues (BBC Session) - Remastered | Led Zeppelin | Coda (Deluxe Edition) => NOT FOUND

Dreams | DJ Quads | Dreams => NOT FOUND

Moby Dick | Led Zeppelin | Led Zeppelin II (1994 Remaster) => NOT FOUND

Stories?? | The Chakachas | Chakachas => NOT FOUND

That\'s All for Everyone - 2015 Remaster | Fleetwood Mac | Tusk (Deluxe Edition) => NOT FOUND

A Horse with No Name | America, George Martin | America => NOT FOUND

SAD! | XXXTENTACION | SAD! => NOT FOUND

Woodstock | Crosby\, Stills & Nash | The 25th Anniversary Rock & Roll Hall Of Fame Concerts => NOT FOUND

Smile | Isaiah Rashad | Smile => NOT FOUND

New Minglewood Blues - Live at Barton Hall, Cornell University, Ithaca, NY 5/8/77 | Grateful Dead | Cornell 5/8/77 (Live) => NOT FOUND

While My Guitar Gently Weeps | Tom Petty, Jeff Lynne, Steve Winwood, Dhani Harrison, Prince | The Best of Rock and Roll Hall of Fame + Museum Live => NOT FOUND

Long Train Runnin\' | The Doobie Brothers | The Captain and Me => NOT FOUND

I Don\'t Know You | The Marías | I Don\'t Know You => NOT FOUND

Um Girassol Da Cor Do Seu Cabelo | Lô Borges | Para Sempre => NOT FOUND

The Boy | Shannon & The Clams | Onion => NOT FOUND

GOODMORNINGTOKYO! | TOKYO’S REVENGE | MDNGHT (SIDE B) => NOT FOUND

Stairway to Heaven - Remaster | Led Zeppelin | Led Zeppelin IV (Remaster) => NOT FOUND

Moonage Daydream - 2012 Remaster | David Bowie | The Rise and Fall of Ziggy Stardust and the Spiders from Mars (2012 Remaster) => NOT FOUND

BULLETPROOF SHOWER CAP | Pouya, City Morgue, ZillaKami, SosMula | BULLETPROOF SHOWER CAP => NOT FOUND

Since I\'ve Been Loving You - (Live at MSG 1973) [Remaster] | Led Zeppelin | The Song Remains the Same (Remaster) => NOT FOUND

Armageddon Time | Willie Williams | Rising Reggae Records => NOT FOUND

Go Away Dream | The Chi-Lites | The Chi-Lites => NOT FOUND

My Love - 2018 Remaster | Wings | Red Rose Speedway => NOT FOUND

Nothing Gold | Vlone Junior | Nothing Gold => NOT FOUND

Love Theme | Michael Small | \'klute\' - Original Soundtrack Recording - Remastered => NOT FOUND

Miles Beyond | Mahavishnu Orchestra | Original Album Classics => NOT FOUND

Here I Go | Syd Barrett | The Madcap Laughs => NOT FOUND

Hoe Cakes | MF DOOM | MM...FOOD => NOT FOUND

Do What You Gotta Do | Nina Simone | The Very Best Of Nina Simone 1967-1972 - Sugar In My Bowl => NOT FOUND

Your Eyes | Hart & Neenan | Rush EP => NOT FOUND

Party And Bullshit | The Notorious B.I.G. | Whos The Man ? Soundtrack => NOT FOUND

Storms - 2015 Remaster | Fleetwood Mac | Tusk (2015 Remaster) => NOT FOUND

On the Highway - Zabriskie Point Remix | Pink Floyd | 1970 Devi/ation => NOT FOUND

Mulo Raro | Supermerk2 | Supermerk2 & Meta Guacha: 2x1 => NOT FOUND

Hold On - Remastered 2010 | John Lennon | Plastic Ono Band => NOT FOUND

Vecchia America | Lelio Luttazzi | Le mie preferite => NOT FOUND

ブリーズ | Jiro Inagaki and His Soul Media | ファンキー・スタッフ => NOT FOUND

Street Market / Love Scene | Michael Small | \'klute\' - Original Soundtrack Recording - Remastered => NOT FOUND

Hour for Magic | Jim Morrison, Music By The Doors | An American Prayer => NOT FOUND

Nam Myoho Renge Kyo | Tee Mac | Soul Jazz Records Presents Nigeria Soul Fever: Afro Funk, Disco And Boogie: West African Disco Mayhem! => NOT FOUND

A Bit of Finger / Sleeping Village / Warning - 2013 Remaster | Black Sabbath | Black Sabbath (2014 Remaster) => NOT FOUND

Alvorada | Cartola | Raizes Do Samba => NOT FOUND

Roadhouse Blues | The Doors | Morrison Hotel => NOT FOUND

FORCE OF HABIT | Paris Texas | FORCE OF HABIT => NOT FOUND

Not Fade Away / Goin\' down the Road Feeling Bad - Live at Manhattan Center, New York, NY, April 5, 1971 | Grateful Dead | Grateful Dead (Skull & Roses) [Live] => UNABLE TO ADD TO PLAYLIST

I\'m Not In Love | 10cc | The Original Soundtrack => NOT FOUND

Rock and Roll - Remaster | Led Zeppelin | Led Zeppelin IV (Deluxe Edition) => NOT FOUND

Oblo\' | Alberto Baldan Bembo | Lingua d\'argento => UNABLE TO ADD TO PLAYLIST

La La Bam-Bam | The Congos | Total Reggae: Classic Roots => UNABLE TO ADD TO PLAYLIST

(Not Just) Knee Deep - 2015 Remaster | Funkadelic | Uncle Jam Wants You - 2015 Remastered Edition => NOT FOUND

Can\'t Take My Eyes off You | Frankie Valli | The Very Best of Frankie Valli & The 4 Seasons => NOT FOUND

Ramblin\' | Johnny Shines | Johnny Shines and Robert Lockwood => UNABLE TO ADD TO PLAYLIST

Kashmir - Remaster | Led Zeppelin | Mothership (Remastered) => NOT FOUND

8:16 A.M. | 311 | Grassroots => UNABLE TO ADD TO PLAYLIST

Debris | Faces | A Nod Is as Good as a Wink... to a Blind Horse => NOT FOUND

Corra E Olhe O Céu | Cartola | Raizes Do Samba => NOT FOUND

To Love Somebody | Nina Simone | To Love Somebody (Expanded Edition) => UNABLE TO ADD TO PLAYLIST

Dancing in the Street - Live at Barton Hall, Cornell University, Ithaca, NY 5/8/77 | Grateful Dead | Cornell 5/8/77 (Live) => NOT FOUND

Express Yourself | Charles Wright & The Watts 103rd Street Rhythm Band | Express Yourself => UNABLE TO ADD TO PLAYLIST

Dazed and Confused - 1990 Remaster | Led Zeppelin | Led Zeppelin => NOT FOUND

Fakes | Papithbk | Thbk => NOT FOUND

Chain of Fools | Aretha Franklin | Lady Soul (With Bonus Selections) => NOT FOUND

New Speedway Boogie - 2013 Remaster | Grateful Dead | Workingman\'s Dead => NOT FOUND

Goldfarb\'s Fantasy | Michael Small | \'klute\' - Original Soundtrack Recording - Remastered => NOT FOUND

Historia de un amor | Pedro Infante | Puras Pa Llorar (Delux) => NOT FOUND

Soul Love - 2012 Remaster | David Bowie | The Rise and Fall of Ziggy Stardust and the Spiders from Mars (2012 Remaster) => NOT FOUND

Belize (feat. MF DOOM) | Danger Mouse, Black Thought, MF DOOM | Cheat Codes => NOT FOUND

Feel Good Inc. | Gorillaz, De La Soul | Demon Days => NOT FOUND

Soul Kitchen | The Doors | The Doors => NOT FOUND

The Loser | Derrick Harriott | Psychedelic Train => NOT FOUND

Life Is Short | Ski Mask The Slump God | Life Is Short => NOT FOUND

Funky Fanfare | Keith Mansfield | The Kpm 1000 Series - Volume 1 => NOT FOUND

Ready or Not Here I Come (Can\'t Hide from Love) | The Delfonics | The Sound Of Sexy Soul => NOT FOUND

サマータイム | SHIGEO SEKITO | 華麗なるエレクトーン -サマータイム- => NOT FOUND

Mountains of the Moon - 2013 Remaster | Grateful Dead | Aoxomoxoa (2013 Remaster) => NOT FOUND

Sister Golden Hair | America | Hearts => NOT FOUND

Flex Season | Yung Gravy | Yung Gravity - EP => NOT FOUND

Cherish the End | Flowervillain | Flowervillain II => NOT FOUND

Free My People | Joni Haastrup | Soul Jazz Records Presents Nigeria Soul Fever: Afro Funk, Disco And Boogie: West African Disco Mayhem! => NOT FOUND

Dreamers Freestyle | Dibyo, Shiloh Dynasty | Lost => NOT FOUND

It Ain\'t Easy - 2012 Remaster | David Bowie | The Rise and Fall of Ziggy Stardust and the Spiders from Mars (2012 Remaster) => NOT FOUND

Can You Feel It | Electric Six | Next Stop ... Soweto Vol. 2: Soultown. R&B, Funk & Psych Sounds from the Townships 1969-1976 => NOT FOUND

La Vie en rose | Édith Piaf | Edith Piaf - The Best Of => NOT FOUND

Bald! | JPEGMAFIA | Bald! => NOT FOUND

Put Your Records On | Ritt Momney | Put Your Records On => NOT FOUND

Over & Over - 2015 Remaster | Fleetwood Mac | Tusk (2015 Remaster) => NOT FOUND

Midnight Pretenders | Tomoko Aran | 浮遊空間 => NOT FOUND

Rocket Man | lovestxr | Rocket Man => NOT FOUND

(Sittin\' On) the Dock of the Bay | Otis Redding | The Dock of the Bay => NOT FOUND

Wish | Diplo, Trippie Redd | Wish => NOT FOUND

Alone Again Or - 2015 Remaster | Love | Forever Changes (2015 Remaster) => NOT FOUND

Breezin\' | George Benson | Breezin\' => NOT FOUND

Aurora Borealis | Meat Puppets | II => NOT FOUND

Left Hand (feat. The Underachievers, Kirk Knight, Nyck Caution & CJ Fly) | Beast Coast, Joey Bada$$, Flatbush Zombies, The Underachievers, Kirk Knight, Nyck Caution, CJ Fly | Escape From New York => NOT FOUND

Mr. Charlie - Live at the Fox Theatre, St. Louis, MO 12/10/71 | Grateful Dead | Mr. Charlie (Live at the Fox Theatre, St. Louis, MO 12/10/71) => NOT FOUND

Box of Rain - 2013 Remaster | Grateful Dead | American Beauty (2013 Remaster) => NOT FOUND

GROUP B | Tyler\, The Creator | GROUP B => NOT FOUND

Acenda O farol | Tim Maia | Chill In Brazil => NOT FOUND

Brown-Eyed Women - Live at Barton Hall, Cornell University, Ithaca, NY 5/8/77 | Grateful Dead | Cornell 5/8/77 (Live) => NOT FOUND

White Rabbit - Live at The Woodstock Music & Art Fair, August 17, 1969 | Jefferson Airplane | Jefferson Airplane: The Woodstock Experience => NOT FOUND

Stuck In The Middle With You | Stealers Wheel | Stealers Wheel => NOT FOUND

Smokin Out The Window | Bruno Mars, Anderson .Paak, Silk Sonic | An Evening With Silk Sonic => NOT FOUND

Ramble on Rose (Live at RFK Stadium, Washington, DC, 6/10/73) | Grateful Dead | Ramble on Rose (Live at RFK Stadium, Washington, DC 6/10/73) => NOT FOUND

Clint Eastwood | Gorillaz, Del The Funky Homosapien | Gorillaz => NOT FOUND

I\'m Sippin\' Tea in Yo Hood | DJ Dread | One Life => NOT FOUND

It Ain\'t Easy, It Ain\'t Easy (feat. Nyck Caution, Kirk Knight, CJ Fly & AKTHESAVIOR) | Beast Coast, Joey Bada$$, Flatbush Zombies, Nyck Caution, Kirk Knight, CJ Fly, AKTHESAVIOR | Escape From New York => NOT FOUND

Feel like Makin\' Love - 2015 Remaster | Bad Company | Straight Shooter => NOT FOUND

A Feast of Friends | Jim Morrison | An American Prayer => NOT FOUND

Champagne Supernova - Remastered | Oasis | (What\'s The Story) Morning Glory? (Deluxe Remastered Edition) => NOT FOUND

Yer Blues - Remastered 2018 | The Dirty Mac | The Rolling Stones Rock And Roll Circus (Expanded) => NOT FOUND

THE STORM | KANYE DROP YOUR ALBUMS | KANYE DROP YOUR ALBUMS => NOT FOUND

Them Bones (2022 Remaster) | Alice In Chains | Dirt (2022 Remaster) => NOT FOUND

Doin\' That Rag - 2013 Remaster | Grateful Dead | Aoxomoxoa (2013 Remaster) => NOT FOUND

Only in the West | Yeek | Only in the West => NOT FOUND

Uncle Albert / Admiral Halsey - Medley / 2012 Remaster | Paul McCartney, Linda McCartney | Ram (Archive Collection) => NOT FOUND

Here I Stand | Africa | Music From “Lil Brown” - Remastered => NOT FOUND

White Sun | The Doobie Brothers | Toulouse Street => NOT FOUND

Conversa De Poeta | Baden Powell | À Vontade => NOT FOUND

I\'m So Lonesome I Could Cry | Hank Williams | The Legend Lives Anew (Hank Williams With Strings) => NOT FOUND

Ay cosita linda | Carlos Argentino, La Sonora Matancera, Pacho Galán | Ave María Lola => NOT FOUND

Can We Pretend | Bill Withers | \'Justments => NOT FOUND

The Queen Bee | Count Basie | Straight Ahead => NOT FOUND

St. Charles Square | Blur | The Ballad of Darren => NOT FOUND

Help on the Way / Slipknot! - 2013 Remaster | Grateful Dead | Blues for Allah (2013 Remaster) => NOT FOUND

Live And Let Die - 2018 Remaster | Wings | Red Rose Speedway (Archive Collection) => NOT FOUND

Cosmic Charlie - 2013 Remaster | Grateful Dead | Aoxomoxoa (2013 Remaster) => NOT FOUND

Riders on the Storm | The Doors | L.A. Woman => NOT FOUND

Angels (feat. Saba) | Chance the Rapper, Saba | Coloring Book => NOT FOUND

Ain\'t No Mountain High Enough | Marvin Gaye, Tammi Terrell | United => NOT FOUND

 |  |  => NOT FOUND

Everywhere - 2017 Remaster | Fleetwood Mac | Tango In the Night (Deluxe Edition) => NOT FOUND

Tell It Like It Is | Aaron Neville | The Very Best Of Aaron Neville => NOT FOUND

Peaceful Easy Feeling - 2013 Remaster | Eagles | Eagles (2013 Remaster) => NOT FOUND

These Arms of Mine | Otis Redding | Pain in My Heart => NOT FOUND

Young Hearts Run Free | Candi Staton | Young Hearts Run Free (US Internet Release) => NOT FOUND

Kiss from a Rose | Seal | Seal => NOT FOUND

Lips of Wine | Dennis Brown | Musical Heatwave, The Best of Dennis Brown 1972-1975 => NOT FOUND

Let Me Down Easy | Dennis Brown | Super Reggae & Soul Hits => NOT FOUND

Living on a Thin Line | The Kinks | Word of Mouth => NOT FOUND

Bad, Bad Leroy Brown | Jim Croce | Life And Times => NOT FOUND

Paris Latino - Original Version 1983 | Bandolero | Best of Bandolero (Le meilleur des années 80) => NOT FOUND

Green Peppers | Herb Alpert & The Tijuana Brass | Whipped Cream & Other Delights => NOT FOUND

Back to the Old House - 2011 Remaster | The Smiths | Louder Than Bombs => NOT FOUND

Bridge over Troubled Water | Aretha Franklin | The Very Best of Aretha Franklin - The 70\'s => NOT FOUND

In the Meantime | Spacehog | Resident Alien => NOT FOUND

Jimi - Blue Suede Jammin\' |  |  => NOT FOUND

Jimi - V town |  |  => NOT FOUND

Jimi - Jeans |  |  => NOT FOUND

Jimi - Bones |  |  => NOT FOUND

Jimi & Love & Stephen Stills |  |  => NOT FOUND

Jimi - Rocky |  |  => NOT FOUND

Vien Is Haryanto - Funky Children |  |  => NOT FOUND

Jimi & Stills - Jam1 |  |  => NOT FOUND

Jimi & Stills - Jam2 |  |  => NOT FOUND

Kerri Chandler, Jerome Sydenham   You\'re In My System Dennis Quin Vocal Mix ft  Troy Denari    IRC14 | S Zmoon |  => NOT FOUND

Long Time Gone - 2005 Remaster | Crosby\, Stills & Nash | Crosby, Stills & Nash => NOT FOUND

Since I First Met You | The Robins | Rock \'n\' Roll with The Robins => NOT FOUND

Waitin\' for the Bus (2006 Remaster) | ZZ Top | Tres Hombres (Expanded 2006 Remaster) => NOT FOUND

Funkytown - Single Version | Lipps Inc. | ドライブが楽しくなる洋楽ヒッツ！70年代 DISCO => NOT FOUND

Gauze | Deftones | Koi No Yokan => NOT FOUND

Lost in A Lonely World | The Ethics | The Best of the Ethics => NOT FOUND

On My Way | Reflection Eternal | Train Of Thought => NOT FOUND

Suite: Judy Blue Eyes - 2005 Remaster | Crosby\, Stills & Nash | Crosby, Stills & Nash => NOT FOUND

ロマンス | 鈴木 弘 | キャット => NOT FOUND

Swerve City | Deftones | Koi No Yokan => NOT FOUND

Rosemary | Deftones | Koi No Yokan => NOT FOUND

Romantic Dreams | Deftones | Koi No Yokan => NOT FOUND

Paint It, Black | The Rolling Stones | Aftermath => NOT FOUND

Entombed | Deftones | Koi No Yokan => NOT FOUND

Whipping Post - Live At The Fillmore East, March 1971 | Allman Brothers Band | At Fillmore East => NOT FOUND

Show Me Love | Robin S | Show Me Love => NOT FOUND

The Only Exception | Paramore | Brand New Eyes => NOT FOUND

Snowblind - 2021 Remaster | Black Sabbath | Vol. 4 (2021 Remaster) => NOT FOUND

It\'s Not My Cross To Bear | Allman Brothers Band | The Allman Brothers Band (Deluxe) => NOT FOUND

It\'s Such a Good Night | Heisenberg & The Albuquerque Kingpins | Breaking Bad Soundtrack (Music Inspired by the TV Series) => NOT FOUND

Hungry Like the Wolf - 2009 Remaster | Duran Duran | Rio (Collector\'s Edition) => NOT FOUND

I Heard It Through The Grapevine - Edit | Creedence Clearwater Revival | Classic Covers => NOT FOUND

Ghost Song | Jim Morrison, The Doors | An American Prayer => NOT FOUND

Friendly Pressure - Into The Sunshine Mix | Jhelisa, Sunship | Friendly Pressure (Sunship Remixes) => NOT FOUND

The Changeling | The Doors | L.A. Woman => NOT FOUND

Hello It\'s Me | Todd Rundgren | Something / Anything? => NOT FOUND

Afraid To Feel | LF SYSTEM | Afraid To Feel => NOT FOUND

Ramblin\' Man | Allman Brothers Band | Brothers And Sisters (Super Deluxe) => NOT FOUND

Mascara | Deftones | Around the Fur => NOT FOUND

Yellow | Coldplay | Parachutes => NOT FOUND

90% of Me Is You | Gwen McCrae | The Best Of Gwen McCrae => NOT FOUND

Gypsy Woman (She\'s Homeless) (La Da Dee La Da Da) - Radio Edit | Crystal Waters | Surprise => UNABLE TO ADD TO PLAYLIST

The Scientist | Coldplay | A Rush of Blood to the Head => NOT FOUND

Day Dreaming | Aretha Franklin | Young, Gifted and Black => NOT FOUND

Anniversary of an Uninteresting Event | Deftones | Deftones => NOT FOUND

Steppin\' Out | Steel Pulse | Earth Crisis => NOT FOUND

(L)MIRL | Deftones | Gore => NOT FOUND

Im From Texas (feat. Slim Thug, Bun B, Kirko Bangz, Z-Ro, Paul Wall) | Trae Tha Truth | Im From Texas (feat. Slim Thug, Z-Ro, Kirko Bangz, Bun B, & Paul Wall) - Single => NOT FOUND

When The Wind Is Blowing | Paul McCartney | Wild Life (Archive Collection) => NOT FOUND

Love In Vain | The Rolling Stones | Let It Bleed => NOT FOUND

Smile | Lily Allen | Alright, Still (Bonus Track Version) => NOT FOUND

No, No, No | Dawn Penn | No, No, No => NOT FOUND

Tonight\'s the Night - 2016 Remaster | Neil Young | Tonight\'s the Night => NOT FOUND

Good To Me As I Am To You | Aretha Franklin | Eric Clapton: Life In 12 Bars (Original Motion Picture Soundtrack) => NOT FOUND

Clocks | Coldplay | A Rush of Blood to the Head => NOT FOUND

You\'re in My System - Dennis Quin Vocal Mix | Kerri Chandler, Jerome Sydenham, Troy Denari, Dennis Quin | You\'re in My System (Dennis Quin Remixes) => NOT FOUND

This Must Be the Place (Naive Melody) - 2005 Remaster | Talking Heads | Speaking in Tongues (Deluxe Version) => NOT FOUND

Creep - 2017 Remaster | Stone Temple Pilots | Core (Super Deluxe Edition) => NOT FOUND

Planet Caravan - 2012 - Remaster | Black Sabbath | Paranoid (Remaster) => NOT FOUND

Rain When I Die (2022 Remaster) | Alice In Chains | Dirt (2022 Remaster) => NOT FOUND

Yesterday - Remastered 2009 | The Beatles | Help! (Remastered) => NOT FOUND

There Is a Light That Never Goes Out - 2011 Remaster | The Smiths | The Queen Is Dead => NOT FOUND

Iris | The Goo Goo Dolls | Dizzy up the Girl => NOT FOUND

Electric Funeral - 2012 - Remaster | Black Sabbath | Paranoid (Remaster) => NOT FOUND

Você E Eu, Eu E Você (Juntinhos) | Tim Maia | Tim Maia 1980 => NOT FOUND

Can\'t Get You out of My Head | Kylie Minogue | Fever => NOT FOUND

Scar Tissue | Red Hot Chili Peppers | Californication (Deluxe Edition) => NOT FOUND

Roller Skates | Steel Pulse | Earth Crisis => NOT FOUND

Ruby Lee | Bill Withers | \'Justments => NOT FOUND

She\'s Gone | Daryl Hall & John Oates | Abandoned Luncheonette => NOT FOUND

プレゼント | 高橋ユキヒロ | サラヴァ! => NOT FOUND

Seven Bridges Road - Live; 2013 Remaster | Eagles | The Very Best of the Eagles (2013 Remaster) => NOT FOUND

Baby, I Love You | Aretha Franklin | Aretha Arrives => NOT FOUND

Floods | Pantera | The Great Southern Trendkill => NOT FOUND

Life Goes On | The Sundays | Life Goes On => NOT FOUND

Dani California | Red Hot Chili Peppers | Stadium Arcadium => NOT FOUND

One of These Nights - 2013 Remaster | Eagles | One of These Nights (2013 Remaster) => NOT FOUND

Dam That River (2022 Remaster) | Alice In Chains | Dirt (2022 Remaster) => NOT FOUND

Night Driver | Tom Petty | Highway Companion => NOT FOUND

Please, Please, Please, Let Me Get What I Want - 2011 Remaster | The Smiths | Hatful of Hollow => NOT FOUND

Coraçao | Jerry Ropero, Denis the Menace, Sabor, Jaqueline | Coraçao => NOT FOUND

Behind Blue Eyes | The Who | Who\'s Next (Deluxe Edition) => NOT FOUND

Junk - Remastered 2011 | Paul McCartney | McCartney (Archive Collection) => NOT FOUND

Like Yesterday | DJ Screw, PSK-13 | 3 ‘n the Mornin’ 20th Anniversary (Deluxe Edition) => NOT FOUND

Whatta Man | Salt-N-Pepa, En Vogue | Very Necessary => NOT FOUND

Runnin\' with the Devil - 2015 Remaster | Van Halen | Van Halen (Remastered) => NOT FOUND

Start Me Up - Remastered 2009 | The Rolling Stones | Tattoo You (2009 Re-Mastered) => NOT FOUND

Chant a Psalm | Steel Pulse | True Democracy => NOT FOUND

Worth His Weight in Gold | Steel Pulse | True Democracy => NOT FOUND

Pa\'que La Pases Bien | Arcángel | Luny Tunes Presents, Calle 434 => NOT FOUND

Symptom of the Universe - 2013 Remaster | Black Sabbath | Sabotage (2014 Remaster) => NOT FOUND

The Sky Is Crying | Elmore James | Presenting Elmore James => NOT FOUND

How Long | Lipps Inc. | Funkyworld: The Best Of Lipps Inc => NOT FOUND

Plush - 2017 Remaster | Stone Temple Pilots | Core (Super Deluxe Edition) => NOT FOUND

Wild Horses - 2009 Mix | The Rolling Stones | Sticky Fingers (Remastered) => NOT FOUND

In The Mix - Fast Eddie Mix | Mixmasters, Mc Action, Fast Eddie | In The Mix => NOT FOUND

What a Fool Believes | The Doobie Brothers | Minute by Minute => NOT FOUND

Doolin-Dalton - 2013 Remaster | Eagles | Desperado (2013 Remaster) => NOT FOUND

You Showed Me | Enoch Light | Enoch Light Y Las Guitarras Radiantes => NOT FOUND

El Cayuco | Tito Puente | Dance Mambo! => NOT FOUND

Stormy Monday - Live At Fillmore East, March 13, 1971 | Allman Brothers Band | At Fillmore East => NOT FOUND

Tequila Sunrise - 2013 Remaster | Eagles | Desperado (2013 Remaster) => NOT FOUND

At the Hotel (Mixed) | Eunice Collins | All Back To (DJ Mix) => NOT FOUND

I Could Die for You | Red Hot Chili Peppers | By the Way (Deluxe Edition) => NOT FOUND

The Lonely Bull (El Solo Toro) | Herb Alpert & The Tijuana Brass | The Lonely Bull => NOT FOUND

A Taste of Honey | Herb Alpert | Presenting Herb Alpert => NOT FOUND

Chrome Hearth Cross | Corkybul | Chrome Hearth Cross => NOT FOUND

This Love | Pantera | Vulgar Display of Power => NOT FOUND

Interrogación | Fresa Salvaje | Interrogación => NOT FOUND

Drown | The Smashing Pumpkins | (Rotten Apples) The Smashing Pumpkins Greatest Hits => NOT FOUND

Ayla Pt. 2 | Ayla | Nirwana => NOT FOUND

Theme From "A Clockwork Orange" - Original | The Starshine Orchestra And Singers | Great Music From Great Movies (Original) => NOT FOUND

Married To The Game | Future | Project E.T. => NOT FOUND

Killing Me Softly With His Song | Roberta Flack | Killing Me Softly => NOT FOUND

Clouds | BUNT., Nate Traveller | Clouds => NOT FOUND

Digital Bath | Deftones | White Pony => NOT FOUND

Mama\'s Boyfriend | yzykirbo | Mama\'s Boyfriend => NOT FOUND

Oh Well, Pt. 1 - 2013 Remaster | Fleetwood Mac | Then Play On (2013 Remaster; Expanded Edition) => NOT FOUND

Doo Doo Doo Doo Doo (Heartbreaker) | The Rolling Stones | Goats Head Soup (Remastered 2009) => NOT FOUND

Schubert: Der Erlkönig | Johann Wolfgang von Goethe, Franz Schubert, Andreas Burkhart, Akemi Murakami | Schubert, Liszt & Wolf: Goethe-Lieder => NOT FOUND

This Christmas | Donny Hathaway | A Donny Hathaway Collection => NOT FOUND

Stand Tall | Dirty Heads | Surf\'s Up Music From The Motion Picture => NOT FOUND

Tweaker | G3 GELO | Tweaker => NOT FOUND

Bodyguard | Steel Pulse | Earth Crisis => NOT FOUND

Ain\'t Talkin\' \'Bout Love - 2015 Remaster | Van Halen | Van Halen (Remastered) => NOT FOUND

Achilles Last Stand - Remaster | Led Zeppelin | Presence (Remaster) => NOT FOUND

Dark Necessities | Red Hot Chili Peppers | The Getaway => NOT FOUND

Asleep in the Desert (Instrumental) | ZZ Top | Tejas => NOT FOUND

Good Times Bad Times - 1993 Remaster | Led Zeppelin | Led Zeppelin => NOT FOUND

Snow (Hey Oh) | Red Hot Chili Peppers | Stadium Arcadium => NOT FOUND

4 + 20 | Crosby\, Stills\, Nash & Young | Deja Vu => NOT FOUND

Station Man | Fleetwood Mac | Kiln House => NOT FOUND

Tangerine - Remaster | Led Zeppelin | Led Zeppelin III (Remaster) => NOT FOUND

F・L・Y（1991 Mix） | Spectrum | GOLDEN☆BEST スペクトラム => NOT FOUND

Eminence Front | The Who | It\'s Hard => NOT FOUND

This Charming Man - 2011 Remaster | The Smiths | The Smiths => NOT FOUND

Moondance - 2013 Remaster | Van Morrison | Moondance (Deluxe Edition) => NOT FOUND

Worth His Weight in Gold | Steel Pulse | True Democracy => NOT FOUND

How It Was (feat. Future) | DJ ESCO | No Sleep => NOT FOUND

Song 2 - 2012 Remaster | Blur | Blur (Special Edition) => NOT FOUND

Starlight | Muse | Black Holes and Revelations => NOT FOUND

Walk on By | Dionne Warwick | Make Way for Dionne Warwick => NOT FOUND

Yes, I\'m Ready | Barbara Mason | Yes I\'m Ready => NOT FOUND

Since I First Met You | The Robins | You Wanted Fun => NOT FOUND

Dollaz + Sense | DJ Quik | Safe + Sound => NOT FOUND

Scrambler | The Sandals | The Original Soundtrack Music From Bruce Brown\'s The Endless Summer => NOT FOUND

More Than a Band | Bridgit Mendler, Naomi Scott, Hayley Kiyoko, Blake Michael, Adam Hicks | Lemonade Mouth => NOT FOUND

Born and Raised In Compton | DJ Quik | Quik Is The Name => UNABLE TO ADD TO PLAYLIST

Theme From "The Endless Summer" | The Sandals | The Original Soundtrack Music From Bruce Brown\'s The Endless Summer => NOT FOUND

Forever | Pete Drake | Steel Funk => NOT FOUND

Tin Cup Chalice | Jimmy Buffett | A-1-A => NOT FOUND

Girls Need Love (with Drake) - Remix | Summer Walker, Drake | Last Day Of Summer => NOT FOUND

Down In A Hole (2022 Remaster) | Alice In Chains | Dirt (2022 Remaster) => NOT FOUND

Bored | Deftones | Adrenaline => NOT FOUND

Slave - Remastered | The Rolling Stones | Tattoo You (2009 Re-Mastered) => NOT FOUND

Bumpy\'s Lament - Remastered 2009 | Isaac Hayes | Shaft (Deluxe Edition) => NOT FOUND

Father And Son | Yusuf / Cat Stevens | Tea For The Tillerman (Remastered 2020) => NOT FOUND

I\'ll Play The Blues For You - Live from the Fabulous Forum, 1972 | Albert King | Live From the Fabulous Forum 1972 => NOT FOUND

Theme From Shaft - Remastered 2009 | Isaac Hayes | Shaft (Deluxe Edition) => NOT FOUND

Bring It On Home To Me | Sam Cooke | Sam Cooke: Portrait Of A Legend 1951-1964 => NOT FOUND

Young Americans - 2016 Remaster | David Bowie | Young Americans (2016 Remaster) => NOT FOUND

Morning Dew - 2013 Remaster | Grateful Dead | The Grateful Dead => NOT FOUND

I Can\'t Tell You Why - 2013 Remaster | Eagles | The Very Best of the Eagles (2013 Remaster) => NOT FOUND

Down by the River - 2009 Remaster | Neil Young, Crazy Horse | Everybody Knows This Is Nowhere => NOT FOUND

Cigarettes and Coffee | Otis Redding | The Soul Album => NOT FOUND

Semi-Charmed Life | Third Eye Blind | Third Eye Blind => NOT FOUND

Cemetry Gates - 2011 Remaster | The Smiths | The Queen Is Dead => NOT FOUND

I\'m Gonna Be (500 Miles) | The Proclaimers | Finest => NOT FOUND

Stormy Night | Roland Burrell | The Best of Roland Burrell => UNABLE TO ADD TO PLAYLIST

Lonesome Cowboy Bill - 2015 Remaster | The Velvet Underground | Loaded (2015 Remaster) => NOT FOUND

Waiting On A Friend - Remastered 2009 | The Rolling Stones | Tattoo You (2009 Re-Mastered) => NOT FOUND

That\'s the Way - Remaster | Led Zeppelin | Led Zeppelin III (Remaster) => NOT FOUND

Into Yesterday | Sugar Ray | Surf\'s Up Music From The Motion Picture => NOT FOUND

Don\'t Let It Bring You Down | Neil Young | After the Gold Rush (2009 Remaster) => NOT FOUND

Mala Mujer | Ranil | The Roots of Chicha 2 => NOT FOUND

Change (In the House of Flies) | Deftones | White Pony => NOT FOUND

Black Limousine - Remastered | The Rolling Stones | Tattoo You (2009 Re-Mastered) => NOT FOUND

The Long And Winding Road - Remastered 2015 | The Beatles | 1 (Remastered) => NOT FOUND

Que Calor | Supermerk2 | Supermerk2 & Meta Guacha: 2x1 => NOT FOUND

Crayola | 9lokknine | Bloodshells Revenge => NOT FOUND

9-24-7000 (feat. Rick Ross) | Action Bronson, Rick Ross | Blue Chips 7000 => NOT FOUND

Leggo Beast | Steel Pulse | True Democracy => NOT FOUND

Tell Me | Duane And The Drifters | Misty b/w Tell Me => NOT FOUND

Witchy Woman - 2013 Remaster | Eagles | Eagles (2013 Remaster) => NOT FOUND

Gimme Shelter | The Rolling Stones | Let It Bleed => NOT FOUND

I\'ll Be Around - 2003 Remaster | The Spinners | Definitive Soul: Spinners => NOT FOUND

Let \'Em In - 2014 Remaster | Wings | Wings At The Speed Of Sound (Archive Collection) => NOT FOUND

Safe + Sound | DJ Quik | Safe + Sound => NOT FOUND

You’ve Succeeded | Dimas III | Royal Jesters: English Oldies => NOT FOUND

I Get Lifted - 2004 Remaster | KC & The Sunshine Band | KC & the Sunshine Band => NOT FOUND

These Dreams of You - 2013 Remaster | Van Morrison | Moondance => NOT FOUND

Maneater | Nelly Furtado | Loose => NOT FOUND

Ooh La La | Faces | Ooh La La => NOT FOUND

Changes | Black Sabbath | The Ultimate Collection => NOT FOUND

Cowgirl in the Sand - Live | Crosby\, Stills\, Nash & Young | 4 Way Street => NOT FOUND

Trouble | Yusuf / Cat Stevens | Mona Bone Jakon (Remastered 2020) => NOT FOUND

The Golden Road - 2013 Remaster | Grateful Dead | The Grateful Dead => NOT FOUND

Hey Little One | Glen Campbell | Hey Little One => NOT FOUND

Beware My Love - 2014 Remaster | Wings | Wings At The Speed Of Sound (Archive Collection) => NOT FOUND

Moonlight Mile - 2009 Mix | The Rolling Stones | Sticky Fingers (Remastered) => NOT FOUND

Baby, Please Don\'t Go (feat. Van Morrison) | Them, Van Morrison | Complete Them (1964-1967) (feat. Van Morrison) => NOT FOUND

Gabriel | Stereolab | Abc Music - The Radio 1 Sessions => NOT FOUND

Get Involved | Raphael Saadiq, Q-Tip | The PJs => NOT FOUND

